#####################
# 8   #         #   #
##### # ####### # # #
#   #e#       # # # #
#d### ####### # # # #
#   #   #     #&# # #
### ###c#/##### # # #
#     #   # #   #e# #
# ######### # ##### #
#           #d#     #
# ######### # ### # #
#   #e    & #  ?  # #
### # ##### ####### #
# # # #  c# #c    ^ #
# # # # # ### #######
#   # / #        *  =
#####################
